7,7,7,7,7,7,7,7,7,7,7,7,7,7,7,7,7,7,7,7,7,7,7,7,7,7,7,7,7,7,
7,13,13,13,13,13,13,13,13,13,13,13,13,13,13,10,13,13,13,13,13,13,13,13,13,13,13,13,13,7,
7,1,1,1,1,1,1,1,1,1,1,1,1,1,1,1,1,1,1,1,1,1,1,1,1,1,1,1,1,7,
7,8,8,8,8,8,8,8,8,8,8,8,8,8,8,8,8,8,8,8,8,8,8,8,8,8,8,8,8,7,
7,1,1,1,1,6,1,1,1,1,1,1,1,1,1,1,1,1,1,1,1,1,1,1,1,1,1,1,1,7,
7,13,13,13,9,9,9,13,13,13,13,13,13,13,13,13,13,13,13,13,13,13,13,10,13,13,13,13,13,7,
7,12,12,13,1,6,1,13,12,12,12,12,12,12,12,12,12,12,12,12,12,12,12,12,12,12,12,7,13,7,
7,12,12,13,1,6,1,13,12,12,12,12,12,12,12,12,12,12,12,12,12,12,12,12,12,12,12,7,13,7,
7,12,12,13,1,6,1,11,12,12,12,12,12,12,12,12,12,12,12,12,12,12,12,12,12,12,12,7,13,7,
7,12,12,13,1,6,1,11,12,12,12,12,12,12,12,12,12,12,12,12,12,12,12,12,12,7,7,7,13,7,
7,12,12,13,1,6,1,13,12,12,12,12,7,7,7,7,7,7,12,12,12,12,12,7,7,7,13,13,13,7,
7,12,12,13,1,6,1,13,12,12,12,7,7,3,3,3,3,7,7,12,12,12,12,7,13,13,13,13,13,7,
7,12,12,13,1,6,1,13,12,12,7,7,3,4,4,4,4,3,7,7,12,12,12,7,13,13,13,13,13,7,
7,5,5,5,1,6,1,5,5,5,7,3,4,4,4,4,4,4,3,7,12,12,12,13,13,13,13,13,13,7,
7,12,5,5,5,5,5,5,5,12,7,3,4,4,4,4,4,4,3,7,12,12,12,13,13,13,13,13,13,7,
7,12,12,5,5,5,5,5,12,12,7,3,4,4,4,4,4,4,3,7,12,12,12,13,13,13,13,13,13,7,
7,12,12,13,1,6,1,13,12,12,7,7,3,4,4,4,4,3,7,7,12,12,12,7,13,13,13,13,13,7,
7,12,12,13,1,6,1,13,12,12,12,7,7,3,3,3,3,7,7,12,12,12,12,7,13,13,13,13,13,7,
7,12,12,13,1,6,1,13,12,12,12,12,7,7,7,7,7,7,12,12,12,12,12,7,7,7,13,13,13,7,
7,12,12,13,1,6,1,13,12,12,12,12,12,12,12,12,12,12,12,12,12,12,12,12,12,7,7,7,7,7,
7,12,12,13,1,6,1,13,12,12,12,12,12,12,12,12,12,12,12,12,12,12,12,12,12,12,12,12,7,7,
7,12,12,13,1,6,1,13,12,12,12,12,12,12,12,12,12,12,12,12,12,12,12,12,12,12,12,12,12,7,
7,12,12,13,1,6,1,13,12,12,12,12,12,12,12,12,12,12,12,12,12,12,12,12,12,12,12,12,12,7,
7,12,12,13,1,6,1,13,12,12,12,12,12,12,12,12,12,12,12,12,12,12,12,7,7,7,7,7,7,7,
7,12,12,13,1,6,1,13,12,12,12,12,12,12,12,12,12,12,12,12,12,12,12,7,0,0,0,0,0,7,
7,12,12,13,1,6,1,13,12,12,12,12,12,12,12,12,12,12,12,12,12,12,12,7,0,0,0,0,0,7,
7,12,12,13,1,6,1,13,12,12,12,12,12,12,12,12,12,12,12,12,12,12,12,7,0,0,0,0,0,7,
7,12,7,7,7,7,7,7,7,7,7,7,7,7,7,7,7,7,7,7,7,7,7,7,0,0,0,0,0,7,
7,12,12,12,12,12,12,12,12,12,12,12,12,12,12,12,12,12,12,12,12,12,12,12,0,0,0,0,0,7,
7,7,7,7,7,7,7,7,7,7,7,7,7,7,7,7,7,7,7,7,7,7,7,7,7,7,7,7,7,7,